https://powcoder.com
代写代考加微信 powcoder
Assignment Project Exam Help
Add WeChat powcoder
https://powcoder.com
代写代考加微信 powcoder
Assignment Project Exam Help
Add WeChat powcoder
11111000000000000000000011111
11111500000000000000000511111
11111011111111111111111011111
11111011000011111000011011111
11111011044011111044011011111
11111011000011111000011011111
11111011111100500111111011111
11111011111101110111111011111
60000011111101110111111200007
11111011111101110111111011111
11111000000001110000000011111
11111111111111111111111111111
11111111111111111111111111111